#########################################################################################################################################################
#########################################################################################################################################################
#########################################################################################################################################################
#######################################################............#...............#...........#........#################################################
#######################################################............#.....#.........#....#.........#.....#################################################
#######################################################..................#..............#......#........#################################################
#######################################################...###########################################...#################################################
#######...............................#...................###########################################...#################################################
#######........................###........................###########################################...............................................#####
#######....................#..........#...................###########################################...............................................#####
#######...#############################################...###########################################...########################...##############...#####
#######...#############################################...###########################################...########################...##############...#####
#######...#############################################...###########################################...########################...##############...#####
#######...#############################################...###########################################...########################...##############...#####
#######...#############################################...###########################################...########################...##############...#####
#######...#############################################...###########################################...########################...##############...#####
#######...########################................................##................##..............................############...##############...#####
#######...########################.S................................................................................############...##############...#####
#######...########################.......................................###........................................############...##############...#####
#######...##############################...###################...#######################...#####################################...##############...#####
#######...##############################...###################...#######################...#####################################...##############...#####
#######...##############################...###################...#######################...#####################################...##############...#####
#######.........####.......................################...........##################...#####################################...##############...#####
#######....................................................................................#####################################...##############...#####
#######.............##.............................#.......................................#####################################...##############...#####
#######...#################################################...........###################..#####################################...##############...#####
#######...##############################...################...........##################...#........................................................#####
#######...##############################...###################...#######################..##........................................................#####
#######...##############################...###################..########################............................................................#####
#######...##############################...####################..#######################...#####################################...##############...#####
#######...########################.....................#...........##......................#####################################...##############...#####
#######...########################........................##...............................#####################################...##############...#####
#######...########################################...#####################...###################################################...##############...#####
#######...########################################..###########....................................................................##############...#####
#######...########################################...##########....................................................................##############...#####
#######...#########################################..##########....................................................................##############...#####
#####................................................############################################################################################...#####
#####................................................############################################################################################...#####
#####......................................................######...................................................................................#####
##################################################............##...###..............................................................................#####
##################################################...............#####........................................................................T.....#####
##################################################...####################################################################################################
#########################################################################################################################################################
#########################################################################################################################################################