#########################################################################################################################################################
#########################################################################################################################################################
#########################################################################################################################################################
#######################################################............#...............#...........#........#################################################
#######################################################............#.....#.........#....#.........#.....#################################################
#######################################################..................#..............#......#........#################################################
#######################################################...###########################################...#################################################
#######################################################...###########################################...#################################################
#######################################################...###########################################...#################################################
#######################################################...###########################################...#################################################
#######################################################...###########################################...#################################################
#######################################################...###########################################...#################################################
#######################################################...###########################################...#################################################
#######################################################...###########################################...#################################################
#######################################################...###########################################...#################################################
#######################################################...###########################################...#################################################
##################################..................................................................................#####################################
##################################.S................................................................................#####################################
##################################.......................................###........................................#####################################
########################################...#############################################...##############################################################
########################################...#############################################...##############################################################
########################################...#############################################...##############################################################
########################################...#############################################...##############################################################
########################################...#############################################...##############################################################
########################################...#############################################...##############################################################
########################################...##############################################..##############################################################
########################################...#############################################...##############################################################
########################################...#############################################..###############################################################
########################################...#############################################...##############################################################
########################################...#############################################...##############################################################
##################################.........................................................##############################################################
########################################################################################...##############################################################
#########################################################################################################################################################
#########################################################################################################################################################
#########################################################################################################################################################
#########################################################################################################################################################
#########################################################################################################################################################
#########################################################################################################################################################
#########################################################################################################################################################
#########################################################################################################################################################
#########################################################################################################################################################
#########################################################################################################################################################
#########################################################################################################################################################
#########################################################################################################################################################