#########################################################################################################################################################
#########################################################################################################################################################
#########################################################################################################################################################
################################...........############............#...............#...........#........#################################################
################################.S.................................#.....#.....x...#....#.........#.....#################################################
################################...........############..................#..............#......#........#################################################
#######################################################...###########################################...#################################################
#######...............................#.................x.###########################################...#################################################
#######.......x................###.....x..................###########################################...............................................#####
#######....................#..........#...................###########################################..x............................................#####
#######...#############################################...###########################################...########################...##############...#####
#######...#############################################...###########################################...########################...##############...#####
########..#############################################...###########################################...########################...........######...#####
#######...#############################################...###########################################...########################.....x.....######...#####
#######...#############################################...###########################################...########################...........######...#####
#######..##############################################...###########################################...########################...##############...#####
#######...########################................................##................##..............................############...##############...#####
#######...########################................x................................................x................############...##############...#####
#######...########################...#...................................###........................................############...##############...#####
#######.x.##############################...###################...#######################...#####################################...##############...#####
#######...##############################...###################...#######################...#####################################...##############...#####
#######...##############################...###################...#######################...#####################################...##############...#####
#######.........####.......................################...........##################...#####################################...##############...#####
#######.....x......................x............................x..........................#####################################...##############...#####
#######.............##.............................#..............................x........#####################################...##############...#####
#######...##############################...################...........###################..#####################################...##############...#####
#######...##############################...################...........##################...#........................................................#####
#######...##############################...###################...#######################..##................x.........................x.............#####
#######...##############################...###################..########################............................................................#####
#######..###############################...####################..#######################...#####################################...##############...#####
#######..#########################.....................#...........##......................#####################################...##############...#####
#######..#########################............x...........##...............................#####################################...##############...#####
#######...########################################...#####################...###################################################...##############...#####
#######...########################################..###########....................................................................##############...#####
#######...########################################...##########..........x...................................x.....................##############...#####
#######...#########################################..##########....................................................................##############...#####
#####................................................############################################################################################...#####
#####.................x....................x.........############################################################################################...#####
#####......................................................######..................##.......##...........##.....#.......................#...........#####
######.###########################################............##...###.......x..........##............#..##................#....#...................#####
######.###########################################...............#####.....................##.....#.................#..........###..........x.......#####
######...#########################################...####################################################################################################
######.T.################################################################################################################################################
#########################################################################################################################################################